numero,fecha,subtotal,valor_total,iva,id_cliente
1,2020-11-01,900,1071,171,1
2,2020-11-02,3600,4284,684,1
3,2020-11-03,6300,7497,1197,2
4,2020-11-04,2700,3213,513,2
5,2020-11-05,1800,2142,342,2
6,2020-11-06,1500,1785,285,3
7,2020-11-07,4200,4998,798,4
8,2020-11-08,10600,12614,2014,4
9,2020-11-09,21800,25942,4142,4
10,2020-11-10,6500,7735,1235,4
